....#.......#.............................##......
....#....####............................##.......
....#.......#...........................##........
............#..........................##.........
............#...........##............##..........
....#############.......##...........##...........
....#.......#####.......##........................
....#.......#...........##........................
....#...................##............#.#.#.#.....
....#..........##.......##........................
....#.........####......##............#.....#.....
....#........##..##.....##########................
............##....##...........##.....#.....#.....
.............##..##...........##..................
..............####...........##.......#.....#.....
...............##...........##....................
#####.......#..............##.........#.#.#.#.....
............#.............##......................
............#............##.......................
......#######...........#########........####.....
............#............................#........
............#.........................####........
............#............................#........
............#............................#........
............#............................#........
